__________________________________________________________________________________________________________________________________
|@|############################################################################################################################|@|
|@|                                                                                                                            |@|
|@|                                                                                                                            |@|
|@|                                                                                                                            |@|
|@|                                                                                                                            |@|
|@|                                                                                                                            |@|
|@|                                                                                                                            |@|
|@|                                                                                                                            |@|
|@|                                                                                                                            |@|
|@|                                                                                                                            |@|
|@|                                                                                                                            |@|
|@|                                                                                                                            |@|
|@|                                                                                                                            |@|
|@|                                                                                                                            |@|
|@|                                                                                                                            |@|
|@|                                                                                                                            |@|
|@|                                                                                                                            |@|
|@|                                                                                                                            |@|
|@|                                     ##############################################                                         |@|
|@|                                                                                                                            |@|
|@|                                                                                                                            |@|
|@|                                                                                                                            |@|
|@|                                                                                                                            |@|
|@|____________________________________________________________________________________________________________________________|@|
##################################################################################################################################
